BBBBBBBBBBBBBBBBBBBBBBBBBBBBBBBBB
BTTTTTTTTTTTTTTTTTTTTTTTTTTTTTTTB
BTTTTTTTTTTTTTTTTTTTTTTTTTTTTTTTB
BTTTTTTTRRRTTTTTTTTTTTTTTTTTTTTTB
BTTTTTTTTTDTTTTTTTTTTTTTTTTTTTTTB
BTDTTTTTTTTTTTTTTTTTTTTTTTTTTTTTB
BTTTTTTTTTTTTTTTTTTTTTTTTTTTTTTTB
BTTTTTTTTTTTTTTTTTTTTTTDTTTTTTTTB
BTTTTTTTTTTTTTTTTTTTTTTTTTTTTTTTB
BTTTTTTTTTTTTTTTTTTTTTTTTTTTTTTTB
BTTTTTTTTTTRTTTTTTTTTTTTTTTTTTTTB
BTTTTTTTTTTTTTTTTTTTTTTTTTTTTTTTB
BTTTTTTTTTTTTTTTTTTTTTTTTTTTTTTTB
BTTTTTTTTTTTTTTTTTTTTTTTTTTTTTTTB
BTTTTTTTTTTTTTTTTTTTTTTTTTTTTTTTB
BTTTTTTTTTTTTTPTTTTTTTTTTTTTTTTTB
BBBBBBBBBBBBBBBBBBBBBBBBBBBBBBBBB
