MMMMMMMMMMMMMMMMMMMMMMMMMMMMMMMMM
MRMTTTTTTTTTTTTMTMTTMTTTTTTTTTTTM
MTMRTTTTTTTMTTVRRRVTMTTTRRRRRRRTM
MDMRTTTRRRRMTTVMRMVTMTTTRRRRTMTTM
MTRRTTTRDRRMRMRRRRVTMTTTTTTRTTTTM
MTDTTTTRRRMMMTTTRMTTMRRTTTTRTTTTM
MTTTTTTTTMRTTTMTRMTTTTTTMDTMTTTTM
MMMMMMMMMMRMMMMMRMMMMMMMMMMMMMMTM
MTTTTTTTTTTTTTTTTTTVVRTTTTTTTTTTM
MTTRRRRRMTMMMTTMMMMVMRRMMMMMMMMMM
MTTRTTTTMTMDMTTMMMMMMRTRRRRRRDRRM
MTTRTMMTMTTRMTTRRRRRMRTTTTTRRRRRM
MTTRTTTTMTTTMTMRRRRRMTMMMTVTTRMMM
MTTRTMMTMTMMMTTTTTTRVVVRMMMMVRTRM
MTTTTMTTMMMRMMMRRTTTMTTTTTDMVTTRM
MTTRTMTTTTTDMVRRRRRRRRRRRRRMMVRPM
MMMMMMMMMMMMMMMMMMMMMMMMMMMMMMMMM